%%%%%%%%%%%%%%%%%%%
%.G.... o  G    . %
%  % %   ..  .    %
%  %G%  ..   G    %
%  %%%.  o.Po . G %
%.  G      oG   . %
%%%%%%%%%%%%%%%%%%%